NO ./img/NO.xpm
SO ./img/SO.xpm
EA ./img/EA.xpm
WE ./img/WE.xpm
EA ./img/EA.xpm


F 220,100,0
C 225,30,0

111111
100011
10N011
100001
111111