NO ./img/NO.xpm
SO ./img/SOS.xpm
WE ./img/WE.xpm
EA ./img/EA.xpm

F 220,100,0
C 25,222,0

        1111111111111111111111111
        1000000000110000000000001
        1011000001110000000000001
        1001000000000000000000011
111111111011000001110000000100001
100000000011000001110111111111111
1111000000000011100000010001
11110000000001110101000100011
11000100100101011100000010001
100001000000000011000000100011
1000N0100000000001101010010001
1100000111010101111101111000111
11110111 1110101 101111010001
11111111 1111111 111111111111