NO ./img/NO.xpm
SO ./img/SO.xpm
WE ./img/WE.xpm
EA ./img/EA.xpm

F 220,100,0
C 225,30,0

1111111111111
1001000000001
10E0011111001
1000110000001
1111111111111