NO ./img/NO.xpm
SO ./img/SO.xpm
WE ./img/WE.xpm
EA ./img/EA.xpm

F 220,100,0
C 25,222,0

        1111111111111111111111111
        1000000000110000000000001
        1011000001110000000000001
        100100000000000000000001
111111111011000001110000000100001
100000000011000001110111111111111
1111000000000011100000010001
1111000000000111010100010001
11000100100101011100000010001
10000100000000001100000010001
1000N0100000000001101010010001
1100000111010101111101111000111
11110111 1110101 101111010001
11111111 1111111 111111111111