11111111111111111111111111111111111
100000000000E100000000000000000G001
1CCCC000000000000000CCCCC1000000011
10000001111111111111111111100000001
10101010101010101010101010101010101
1P0000000C00C00000000000000000000C1
11111111111111111111110000000111111
10000000000000000000000000000011111
100C0001111111011111111111111111111
100000000000000000000000C0000011111
11111111111100000000000011111111111
11111111111111110011111111111111111
1CCCC000000000000000CCCCC1000000011
10101010101010101010101010101010101
100000000C00C00000000000000000000C1
10000001111111111111111111111111111
100000000000000000000000C0000011111
11111111111100000000000E11111111111
11111111111111111111111111111111111
