1111111111111
1P010P00P0C1
1000011111001
1P0011P0C0001
1111111111111
