1111111111111
1P010000000C1
10E0011111001
10001100C0001
1111111111111
