11111111111111111
10000001000011111
11111E0000C000001
1P000000000000001
11111111111111111
