111111111111111111111111111111111111
1000000000000C000000000C0000000C0001
1111E1111111110011111101001110111011
10G0000000000000000000000000000000P1
100C1110011110000000111100001C1C1001
111000111000011111110000111100010111
11000000000000000000000000000000CC11
111110011111111110011111111111111111
1000000000000000000000000C0000000001
1CCC000011111111111111111100000CCC01
100000000000000000000000000000000011
111111111111111111111111111111111111
