1111111111111
1C000P000C0C1
1000000000001
1C0000E000001
1111111111111
